NO ./texturs/nort.xpm
SO ./texturs/south.xpm
WE ./texturs/wst.xpm
EA ./texturs/east.xpm
F 61,59,64
C 3,6,55
1111111111111111111111111
1000000000110000000000001
1011000001110000000000001
1001000000000000000000001
1111100110110000011100001                        1
10000000001100000111011111111                   101
11110000000000011100000010001                    1
11110000000000011101010010011
11000000000000011100000010001
10000000N00000001100000010001
10000000000000001101010010001
1100000111010101111101111100111
11110111 1110101 101111010001
11111111 1111111 111111111111